x x x x x x x
x o o o o o x
x o x o x o x
x o o x o x x
x x o x o x x
x o o o o o x
x x x x x x x
